wwwwwwwwwwwwwwwwwwwwwwwwwwwwwwwwww
w      w    w    w      w        w
w                                w
w    m                      m    w
w      w    w    w      w        w
wwwwwwwww  ww    www  www        w
w    w      w    w      w        w
w           ww  ww      w        w
w         m      w      w        w
w    w           w  m   w        w
w    w      w    w      w    m   w
w    w      w    w      w        w
www  www  wwww  wwww  wwwwww  wwww
w                                w
w    m                           w
wwww     wwww  ww    wwwww  wwwwww
w  p       w    w    w           w
w          w    w    w       m   w
w          w    w    w           w
w          wwwwww    wwwwwwwwwwwww
w          w                     w
w      m   w                     w
w          w        m            w
w          w                     w
wwwwwwwwwwwwwwwwwwwwwwwwwwwwwwwwww